[name]
No Way Out?
[color]
155, 170, 141
[time]
200
[robot]
3
[data]
11
   ###     ### -|
  6###     ###  |
   ###     ###  |
 >>>>>          |
 !    >        4|
 !  T  >        |
 !  T   >       |
 !  T    >     b|
 ----     >    b|
-          >>>>>|
                |
