[name]
Slices
[color]
180, 15, 65
[time]
128
[robot]
3
[data]
18
                |
T               |
T               |
T               |
->             -|
  >           - |
   >         .  |
#   >   #   -   |
#    >  #  -    |
#     > # -     |
--     ---     -|
  -           - |
   -         -  |
#   -   #   -   |
#    -  #  -    |
#     - # -     |
--     ---     -|
                |
